###############
#.,.,.,.,.,.,.#
#,.,.,.,.,.,.,#
#.,.,.,.,.,.,.#
#,.,.,.,.,.,.,#
#.,.,.,.,.,.,.#
#,.,.,.,.,.,.,#
#.,.,.,.,.,.,.#
#,.,.,.,.,.,.,#
#.,.,.,.,.,.,.#
#,.,.,.,.,.,.,#
#.,.,.,.,.,.,.#
#,.,.,.,.,.,.,#
#.,.,.,.,.,.,.#
###############